*****************************
*...........................*
*..*....*...*....*...*...*..*
*.....*............*...*...**
**..*.....**....**..........*
*.......*.....*.....*..*..*.*
*....**....*.....*........*.*
*****************************