*************************************************************************
*.......................................................................*
*..*.........*.................**..........**............***..*...*.....*
*....*...*......*......*............*.*.*..........**.................***
*................*..*.....*......*.......**...*..........*...*.*........*
*.***.....*..*.......*........*......**............**................**.*
*................**.....*.......**....*.......*...........*........*....*
*...........................*...........*..........**..................**
*..........**.......**....*...**..............**............**........***
*....*..........*........*..........***..............**...........**....*
*........**...*......*........**............**..............**.........**
*....*...*......*......*............*.*.*..........**.................***
*...........................*...........*..........**..................**
*....*..........*........*..........***..............**...........**....*
*.***.....*..*.......*........*......**............**................**.*
*..*.........*.................**..........**............***..*...*.....*
*************************************************************************